########################################################################################################################
|                                                                                                                      |
| ###################################################### ##############################################################|
| #                  #                                 #                                                              #|
| # ################ # ################ ############### # ############################################################ |
| #                  # #               #               # #                                                             |
| ############# ##### # ############# # ############# # ############################################################## |
|               #     # #           # #             # #                                                              # |
|############## # ##### # ####### ### ############# # ##############################################################   |
|             # #     # #     #   #   #             # #                                                              # |
| ########### # ##### # ### # # # ### # ############# # ############################################################   |
| #           #       #   # # # # # # #               #                                                              # |
| # ##################### # ### # # # # ####################################################################### #####  |
| #                       #     # # # #                                                              #         #     # |
| ######################### ### # # # ##################################################################### ### # ###  |
|                           # # # # # #                                                              # #   #   # # #   |
| ########################### # # # # ################################################################# # ### ### # #  |
| #                           # # # #                                                              #   #   #   # # #   |
| # ########################### # # # ################################################################### # # # # # #  |
| # #                           # # # #                                                            #     # # # # # #   |
| # # ########################### # # ################################################################# ### # # # # #  |
| # #                             # #                                                            # #     # # # # # #   |
| # ############################### ################################################################### # # # # # # #  |
| # #                               #                                                            #   # # # # # # # #   |
| # # ############################### ########################################################### ### # # # # # # # #  |
| # # #                               #                                                          #   # # # # # # # ##  |
| # # # ############################### ########################################################### ### # # # # #      |
| # # # #                               #                                                          #   # # # # ##  ##  |
| # # # # ############################### ########################################################### ### # # # #   #  |
| # # # # #                               #                                                          #   # # # # ####  |
| # # # # # ############################### ########################################################### ### # # # # #  |
| # # # # # #                               #                                                          #   # # # # ####|
| # # # # # # ############################### ########################################################### ### ######   |
| # # # # # # #                               #                                                          #        ## # |
| # # # # # # # ############################### ############################################################## #  ## # |
| # # # # # # # #                               #                                                            # #  #  # |
| # # # # # # # # ############################### ############################################################ ####  # |
| # # # # # # # # #                               #                                                          #       # |
##############################################################################################################   #######
